NO ./textures/Wall2.xpm
SO ./textures/Wall7.xpm
WE ./textures/Wall4.xpm
EA ./textures/Wall8.xpm

F 123, 123, 123
C 123, 123, 100

111111111111111111111111111111111111
100000000000000000000000000000000001
100000000000000000000000000000000001
100000000000000000000000000000000001
100000000000000000000000000000000001
100000000000000000000000000000000001
100000000000000000000000000000001111
100000000000000000000000000000001  1
10000000000000000000000000000N001  1
100000000000000000000000000000001  1
100000000000000000000000000000001111
100000000000000000000000000000000001
100000000000000000000000000000000001
100000000000000000000000000000000001
100000000000000000000000000000000001
100000000000000000000000000000000001
100000000000000000000000000000000001
100000000000000000000000000000000001
111111111111111111111111111111111111