NO ./textures/Wall2.xpm
SO ./textures/rainbow.xpm
WE ./textures/pepe.xpm
EA ./textures/Wall8.xpm

C 0, 50, 200
F 100, 100, 100


        11111111111111111111111111111111111111111111111111111111111111111111111111111111111111111111
        10001000001100000000W10000000100010000000000000000000000000000000000000100100010000000000001
        10110000011100000000000000000100010001000010000010000010000000010000010100100010000000000001
        10010000000000000000000000100001000001000010000010000010000000010000010000001000000000000001
1111111110110000011100000000000000100001000000000000000000000000000000000000000000001000000000000001
1000000000110000011101111111011111111111111111111111111000111111111111111111111111111111111111111111
111101111111110111000000100011                        100001
11110111111111011101010010001                         100001 
11000000110101011100000010001                         100001 
10000000000000001100000000001                         100001 
10000000000000001101010010001                         100001
1100000111010101111101111000111                       100001 
11110111 1110101 101111010001                         100001
1000000111000001 100001111111                         100001
100000000000000111000000000011111111111111111111111111100011111111111111111111111111111111111111111
111100000000000000000000000000000000000000000011111111100000000000000000000000000000000000000000001
110000000000000000000000000000000010000000000000000000111111110000000000000000000000000001111111011
111111111111111110000000000111110000000000000000000000000000000000000000000000000000000000000000001
111111111111100000000000000000000000000000000000000000000000000000000000000000000000000000000000001
111111111111100000000000000000000000000000000000000000000000000000000000000000000000000000000000001
111111111111100000000000000000000000000000000000000000000000000000000000000000000000000000000000001
111111111111100000000000000000000000000000000000000000000000000000000000000000000000000000000000001
111111111111100000000000000000000000000000000000000000000000000000000000000000000000000000000000001
111111111111100000000000000000100000000000000000000000000000000000000000000000000000000000000000001
111111111111100000000000000000100000000000000000000000000000000000000000000000000000000000000000001
111111111111100000000000000000100000000000000000000000000000000000000000000000000000000000000000001
111111111111100000000000000000100000000000000000000000000000000000100000000000000000000000000000001
111111111111100000000000000000100000000000000000000000000000000000100000000000000000000000000000001
111111111111100000000000000000100000000000000000000000000000000000100000000000000000000000000000001
111111111111100000000000000000100000000000000000000000000000000000100000000000000000000000000000001
111111111111100000000000000000100000000000000000000000000000000000100000000000000000000000000000001
111111111111100000000000000000100000000000000000000000000000000000100000000000000000000000000000001
111111111111100000000000000000100000000000000000000000000000000000100000000000000000000000000000001
111111111111100000000000000000100000000000000001000000000000000000100000000000000000000000000000001
111111111111100000000000000000100000000000000001000000000000000000100000000000000000000000000000001
111111111111100000000000000000000000000000000001000000000000000000100000000000000000000000000000001
111111111111100000000000000000000000000000000001000000000000000000100000000000000000000000000000001
111111111111100000000000000000000000000000000001000000000000000000100000000000000000000000000000001
111111111111100000000000000000000000000000000001000000000000000000000000000000000000000000000000001
111111111111100000000000000000000000000000000001000000000000000000000000000000000000000000000000001
111111111111100000000000010000000000000000000001000000000000000000000000000000000000000000000000001
111111111111100000000000010000000000000000000001000000000000000000000000000000000000000000000000001
111111111111100000000000010000000000000000000001000000000000000000000000000000000000000000000000001
111111111111100000000000010000000000000000000001000000000000000000000000000000000000000000000000001
111111111111100000000000010000000000000000000001000000000000000000000000100000000000000000000000001
111111111111100000000000010000000000000000000000000000000000000000000000100000000000000000000000001
111111111111100000000000010000000000000000000000000000000000000000000000100000000000000000000000001
111111111111100000000000010000000000000000000000000000000000000000000000100000000000000000000000001
111111111111100000000000010000000000000000000000000000000000000000000000100000000000000000000000001
111111111111100000000000010000000000000000000000000000000000000000000000100000000000000000000000001
111111111111100000000000010000000000000000000000000000000000000000000000100000000000000000000000001
111111111111100000000000010000000000000000000000000000000000000000000000100000000000000000000000001
111111111111100000000000000000000000000000000000000000000000000000000000100000000000000000000000001
111111111111100000000000000000000000000000000000000000000000000000000000100000000000000000000000001
111111111111100000000000000000000000000000000000000000000000000000000000100000000000000000000000001
111111111111100000000000000000000000000000000000000000000000000000000000100000000000000000000000001
111111111111100000000000000000000000000000000000000000000000000000000000000000000000000000000000001
111111111111100000000000000000000000000000000000000000000000000000000000000000000000000000000000001
111111111111100000000000000000000000000000000000000000000000000000000000000000000000000000000000001
111111111111100000000000000000000000000000000000000000000000000000000000000000000000000000000000001
111111111111100000000000000000000000000000000000000000000000000000000000000000000000000000000000001
111111111111100000000000000000000000000000000000000000000000000000000000000000000000000000000000001
111111111111100000000000000000000000000000000000000000000000000000000000000000000000000000000000001
111111111111100000000000000000000000000000000000000000000000000000000000000000000000000000000000001
111111111111100000000000000000000000000000000000000000000000000000000000000000000000000000000000001
111111111111100000000000000000000000000000000000000000000000000000000000000000000000000000000000001
111111111111100000000000000000000000000000000000000000000000000000000000000000000000000000000000001
111111111111100000000000000000000000000000000000000000000000000000000000000000000000000000000000001
111111111111100000000000000000000000000000000000000000000000000000000000000000000000000000000000001
111111111111100000000000000000000000000000000000000000000000000000000000000000000000000000000000001
111111111111100000000000000000000000000000000000000000000000000000000000000000000000000000000000001
111111111111100000000000000000000000000000000000000000000000000000000000000000000000000000000000001
111111111111111111111111111111111111111111111111111111111111111111111111111111111111111111111111111